AAAAAAAAΰBBBBBBBBBBBBBBBBBBBBBBBBBBBB—BB
AAAAAAASSDSSSSBBBBBBSSSSSSSSSSSBBBBBBBBB
AAAAAASSSSSSSSSBBSSSSSSSSSSSSSSSSSBBBBBB
AAAABBBBBBBBBBBBSSSSSSSSSSSSSSSSSSSSBBBB
B♥BBBBBBBBSSSSSSSSSSSSSSSSSSSSSSSSSSSBBB
BBBSSSSSSSSSSSSSSSSSSSSSSSSSSSSSSSSSSSSS
BBSSSSSSSSSSSSSccccccccccccccccccccccccc
BBSSSSSSSSSSSSSccccccccccccccccccccTcccc
BSSSSSSSSSSSSSScccSSSSSSSSSSSSSSSSSSSSSS
BSSSSSSSSSSSSSScccSSSSSSSSSSSSSSSSSSSSSS
MMSSSSSSSSSSSSScccSSSSSEEEPPEEEPPPPEEEP♥
MMMSSSSSSSSSSSScccSSSSSEEEPPEEEPPPPEEEPP
MMMMSSSSSSSSSSScccSSSSSPPPPPPPPPPPPPPPPP
MMMMMMMSSSSSSSScccSSSSSPPPPPPPPPPPPPPPPP
MMMMM♥SSSSSSSSScccSSSSSEEEPPhhhPPEEEPPEE
MMMMMMMSSSSSSSScccSSSSSEEEPPhHhPPEEEPẅEE